1111111111111111111111111111111111111111
1000000000000000000000000000000000000001
1000000000000010000000000100000000000001
100000000000001000C000000100000000000001
1000000000001000000000000000100000000001
10000000P0000000000000000001000000E00001
1000000000000000000000000000000000000001
1000000000000000000000000000000000000001
1111111111111111111111111111111111111111
