1111111111111111111111111111111111111111
10000C000000000000000000000000000C000001
1000000000000010000000000100000000000001
100000C0000000100000000001000C0000000001
10000000000010000000000000001000E0000001
1000000000000000000000000001000000000001
10N00000000000P0000000000000000000000001
1000000000000000000000000000000000000001
1111111111111111111111111111111111111111